52 20
50 9
19
3 0
2 2 2 2 2 2 2 2 2 0 0 0 2 2 2 2 2 2 2 2
2 2 0 0 0 0 0 0 0 0 0 0 0 0 0 0 0 0 0 2
2 2 0 0 0 0 0 0 0 0 0 0 0 0 0 0 0 0 0 2
2 2 1 0 0 2 2 2 2 2 2 2 2 2 2 2 2 2 2 2
2 2 0 0 0 2 2 2 2 2 2 2 2 2 2 2 2 2 2 2
2 2 0 0 0 0 0 0 0 0 0 0 0 0 0 0 0 0 0 2
2 2 0 0 0 0 0 0 0 0 0 0 0 0 0 0 1 0 0 2
2 2 0 0 0 0 0 0 0 0 0 0 0 0 0 0 0 0 0 2
2 2 2 2 2 2 2 2 2 2 2 2 2 2 2 2 2 0 0 2
2 2 2 2 2 2 2 0 0 0 1 0 0 2 2 2 2 0 0 2
2 2 2 2 2 2 0 0 0 2 2 0 0 0 2 2 2 0 0 2
2 2 2 2 2 0 0 0 2 2 2 2 0 0 0 2 2 0 0 2
2 2 2 2 0 0 0 2 2 2 2 2 2 0 0 0 2 0 0 2
2 0 0 0 0 0 2 2 2 2 2 2 2 2 0 0 0 0 0 2
2 0 0 0 0 0 2 2 2 2 2 2 2 2 0 0 0 0 0 2
2 0 0 0 0 0 0 2 2 2 2 2 2 0 0 0 2 2 2 2
2 0 0 0 2 0 0 0 2 2 2 2 0 0 0 2 2 2 2 2
2 0 0 0 2 2 0 0 0 2 2 0 0 0 2 2 2 2 2 2
2 0 0 0 2 2 2 0 0 0 0 0 0 2 2 2 2 2 2 2
2 0 0 0 2 2 2 2 2 2 2 2 2 2 2 2 2 2 2 2
2 0 0 0 2 2 2 2 0 0 0 0 0 0 0 0 0 0 0 2
2 0 0 0 2 2 2 2 0 0 0 0 0 0 0 0 1 1 0 2
2 0 0 1 2 2 2 2 0 0 2 2 2 2 2 2 1 1 0 2
2 0 1 0 2 2 2 2 0 0 2 2 2 2 2 2 0 0 0 2
2 0 0 0 0 0 0 0 0 0 2 2 0 0 0 2 0 0 0 2
2 0 0 0 0 0 0 0 0 0 2 2 0 0 0 2 0 0 0 2
2 2 2 2 2 2 2 2 2 2 2 2 0 0 0 2 0 0 0 2
2 2 2 2 2 2 2 2 2 2 2 2 0 0 0 2 0 0 0 2
2 0 0 0 0 0 0 0 0 0 0 0 0 0 0 2 0 0 0 2
2 0 0 0 0 0 0 0 0 0 0 0 0 0 0 2 0 0 0 2
2 0 0 0 0 0 0 0 0 0 0 0 1 0 0 2 0 0 0 2
2 0 0 2 2 1 0 0 2 2 2 2 2 2 2 2 0 0 0 2
2 0 0 2 2 0 0 0 2 2 2 2 2 2 2 2 0 0 0 2
2 0 0 2 2 0 0 0 2 2 2 2 2 2 2 0 0 0 0 2
2 0 0 2 2 0 0 1 2 2 2 2 2 2 2 0 0 0 0 2
2 1 0 2 2 0 0 0 2 2 2 2 2 2 2 0 1 0 0 2
2 0 0 2 2 0 0 0 2 2 2 2 2 0 0 0 0 0 0 2
2 0 0 2 2 0 0 0 2 2 2 2 2 0 0 0 0 0 2 2
2 0 0 2 2 0 0 0 2 2 2 0 0 0 0 0 0 0 2 2
2 0 0 2 2 0 0 0 2 2 2 0 0 0 0 0 2 2 2 2
2 0 0 2 2 0 0 0 0 0 1 0 0 0 0 0 2 2 2 2
2 0 0 2 2 0 0 0 0 0 0 0 0 0 2 2 2 2 2 2
2 0 0 2 2 0 0 0 0 0 0 0 0 0 2 2 2 2 2 2
2 0 0 2 2 2 2 2 2 2 2 2 2 2 2 2 2 2 2 2
2 0 0 2 2 2 2 2 2 2 2 2 2 2 2 2 2 2 2 2
2 0 0 1 0 0 0 0 0 0 0 0 0 0 0 0 0 0 2 2
2 0 0 0 0 0 0 0 0 0 0 0 0 0 0 0 0 0 2 2
2 2 2 2 2 2 2 2 2 2 2 2 2 2 2 2 0 0 2 2
2 2 2 2 2 2 2 2 2 2 2 2 2 2 2 2 0 0 2 2
2 0 0 0 0 0 0 0 0 0 0 0 0 0 0 0 0 0 2 2
2 0 0 0 0 0 0 0 0 0 0 0 0 0 0 0 0 0 2 2
2 1 1 1 1 1 1 1 1 4 4 4 1 1 1 1 1 1 1 2
3 9 0 1
3 10 0 1
3 11 0 1
1 5 5 1
1 5 6 1
1 5 7 1
1 17 12 1
1 18 12 1
1 5 15 1
1 1 24 1
1 8 23 1
1 9 23 1
1 18 30 1
1 17 30 1
1 16 30 1
1 10 42 1
1 2 35 1
1 16 48 1
1 17 48 1