40 20
38 9
10
3 0
2 2 2 2 2 2 2 2 2 0 0 0 2 2 2 2 2 2 2 2
2 0 0 0 0 0 0 0 0 0 0 0 0 0 0 0 0 0 0 2
2 0 0 0 0 0 0 0 0 0 0 0 0 0 0 0 0 0 0 2
2 2 0 0 0 2 2 2 2 2 2 2 2 2 2 2 2 2 2 2
2 2 0 0 1 2 2 2 2 2 2 2 2 2 2 2 2 2 2 2
2 2 0 0 1 0 0 0 0 0 0 2 2 2 2 2 2 2 2 2
2 2 0 1 0 0 0 0 0 0 0 2 2 2 2 2 2 2 2 2
2 2 0 0 0 0 0 0 0 0 0 2 2 2 2 2 2 2 2 2
2 2 2 2 2 2 2 2 0 0 0 2 2 2 2 2 2 2 2 2
2 2 2 2 2 2 2 2 0 0 0 2 2 2 2 2 2 2 2 2
2 2 2 2 2 2 0 0 0 0 0 0 0 2 2 2 2 2 2 2
2 2 2 2 2 2 0 0 0 0 0 0 0 2 2 2 2 2 2 2
2 2 2 2 2 2 0 0 0 0 0 0 0 2 2 2 2 2 2 2
2 2 2 2 0 0 0 0 1 1 1 0 0 0 0 2 2 2 2 2
2 2 2 2 0 0 0 0 1 2 1 0 0 0 0 2 2 2 2 2
2 2 0 0 0 0 1 1 1 2 1 1 1 0 0 0 0 2 2 2
2 2 0 0 0 0 1 2 2 2 2 2 1 0 0 0 0 2 2 2
2 2 0 0 1 1 1 2 2 2 2 2 1 1 1 0 0 2 2 2
2 2 1 0 1 2 2 2 2 2 2 2 2 2 1 0 0 2 2 2
2 2 0 0 1 2 2 2 2 2 2 2 2 2 1 0 0 2 2 2
2 2 0 0 1 1 1 1 1 1 1 1 1 1 1 0 0 2 2 2
2 2 0 0 0 0 0 0 0 0 0 0 0 0 0 0 0 2 2 2
2 2 0 0 0 0 0 0 0 0 0 0 0 0 0 0 0 2 2 2
2 2 0 0 0 2 2 2 2 2 2 2 2 2 2 2 2 2 2 2
2 2 0 0 0 2 2 2 2 2 2 2 2 2 2 2 2 2 2 2
2 2 0 0 0 1 0 0 0 0 0 0 0 0 0 0 0 0 1 2
2 2 0 0 0 1 0 0 0 0 0 0 0 0 0 0 0 0 0 2
2 2 0 0 0 0 0 0 0 0 0 0 0 0 0 0 1 0 0 2
2 2 2 2 2 2 2 2 2 2 2 2 2 2 2 2 0 0 0 2
2 2 2 2 2 2 2 2 2 2 2 2 2 2 2 2 0 0 0 2
2 2 2 0 0 0 0 0 0 0 1 2 2 2 2 2 0 0 0 2
2 2 2 0 0 0 0 0 1 0 0 2 2 2 2 2 0 0 0 2
2 2 2 0 0 0 2 2 0 0 0 0 0 0 0 0 0 0 0 2
2 2 2 0 0 0 2 2 0 0 0 0 0 0 0 0 0 0 0 2
2 2 2 0 0 0 2 2 2 2 2 2 2 2 2 2 2 2 2 2
2 2 2 0 0 0 2 2 2 2 2 2 2 2 2 2 2 2 2 2
2 0 0 0 0 0 0 0 0 0 0 0 0 0 0 0 0 0 0 2
2 0 0 0 0 0 0 0 0 0 0 0 0 0 0 0 0 0 0 2
2 0 0 0 0 0 0 0 0 0 0 0 0 0 0 0 0 0 0 2
2 1 1 1 1 1 1 1 1 1 1 1 1 1 1 1 1 1 1 2
1 5 27 1
1 3 17 1
1 17 26 1
2 10 12 1
2 11 12 1
2 12 12 1
2 13 12 1
1 8 8 1
1 9 8 1
1 10 8 1