20 20
18 9
6
0 2
2 2 2 2 2 2 2 2 2 0 0 0 2 2 2 2 2 2 2 2
2 0 0 1 0 0 0 0 0 0 0 0 0 0 0 0 0 0 0 3
2 0 0 0 0 0 0 1 0 0 0 0 0 0 0 0 0 0 0 2
1 2 2 2 3 2 2 2 2 0 0 0 2 2 2 2 2 2 3 2
2 1 1 2 3 2 2 3 2 0 0 0 2 2 2 2 3 2 2 2
2 2 0 0 0 0 0 0 0 0 0 0 2 3 2 2 2 2 2 2
2 2 1 1 0 0 0 1 1 0 0 0 2 2 2 2 2 3 2 2
2 2 0 0 0 0 0 0 0 0 0 0 2 3 2 3 2 2 2 2
2 2 0 0 0 2 2 2 3 3 2 2 2 3 2 1 2 2 2 2
2 2 0 0 0 2 2 2 2 2 2 2 2 2 2 2 2 2 2 2
2 2 1 1 0 0 0 1 0 0 0 0 0 0 0 0 2 3 2 2
2 2 0 0 0 0 0 1 0 0 1 0 0 0 0 0 2 2 2 2
2 2 0 0 0 0 0 0 0 0 0 0 0 1 0 0 2 2 3 2
2 2 2 2 2 3 2 2 2 2 2 2 2 0 0 0 2 3 3 2
2 2 3 2 1 1 3 2 2 3 2 2 2 1 0 0 2 3 3 2
2 2 2 2 1 1 2 2 3 2 3 2 2 0 0 0 2 2 2 2
2 0 0 0 0 0 0 0 0 0 0 0 0 0 0 0 0 0 0 2
2 0 0 0 0 0 0 0 0 0 0 0 0 0 0 0 0 0 0 2
2 0 0 0 0 0 0 0 0 0 0 0 0 0 0 0 0 0 0 2
2 1 1 1 1 1 1 1 1 1 1 1 1 1 1 1 1 1 1 2
1 9 3 1
1 10 3 1
1 11 3 1
3 9 0 1
3 10 0 1
3 11 0 1