52 20
50 9
19
1 30
3 2 2 2 2 2 2 2 2 0 0 0 2 2 2 2 2 2 2 2
2 3 0 0 0 0 0 0 0 0 0 0 0 0 0 0 0 0 0 2
3 2 0 0 0 0 0 0 0 0 0 0 0 0 0 0 0 0 0 2
3 2 1 0 0 2 3 3 3 2 3 3 2 3 2 3 2 2 1 1
2 3 0 0 0 2 3 2 3 2 1 3 2 2 3 2 2 2 3 2
2 2 1 0 0 0 0 0 0 0 0 0 0 0 0 0 0 0 0 2
1 2 0 0 0 0 0 0 0 0 0 0 0 0 0 0 1 0 0 2
2 2 0 0 0 0 0 0 0 1 0 0 0 0 0 0 0 0 0 2
3 2 2 2 2 2 2 3 2 3 2 2 2 2 2 2 2 0 0 2
3 2 2 3 2 3 2 0 0 0 1 0 0 2 3 2 2 0 0 2
3 2 2 2 2 2 0 0 0 2 2 0 0 0 2 2 2 0 0 2
2 2 3 2 2 0 0 0 2 3 2 2 0 0 0 3 2 0 0 2
2 3 2 2 0 0 0 2 2 2 2 2 3 0 0 0 2 0 0 2
2 0 0 0 0 0 3 2 3 2 3 2 2 2 0 0 0 0 0 2
2 0 0 0 1 0 2 2 2 1 2 2 1 2 0 0 0 0 0 2
2 0 0 0 0 0 0 2 1 2 3 2 2 0 0 0 2 2 2 2
2 1 0 0 2 0 0 0 2 2 2 2 0 0 0 3 2 3 2 2
2 0 0 0 3 2 0 0 0 2 2 0 0 0 2 2 3 2 2 2
2 0 0 0 2 2 1 0 0 0 0 0 0 2 2 3 2 2 2 2
2 0 1 0 3 2 2 2 3 2 2 3 2 2 2 3 2 2 1 2
2 0 0 0 2 3 2 2 0 0 0 0 0 0 0 0 0 0 0 2
2 0 0 0 2 2 3 2 0 0 0 0 0 0 0 0 1 1 0 2
2 0 0 1 2 1 1 2 0 0 2 2 3 2 2 2 1 1 0 2
2 0 1 0 2 2 3 2 0 0 2 3 2 2 3 2 0 0 0 2
2 0 0 1 0 0 0 0 1 0 2 2 0 0 0 2 0 0 0 2
2 0 0 0 0 0 0 0 0 0 2 3 0 0 0 3 0 0 0 2
2 2 2 3 2 3 2 2 2 2 2 2 0 0 0 2 0 0 0 2
2 2 3 2 2 1 2 3 1 3 2 2 0 0 0 3 0 0 0 2
2 0 0 0 0 0 0 0 1 0 0 0 0 0 0 2 0 1 0 2
2 0 0 1 0 0 0 0 0 0 0 0 0 0 0 2 0 0 0 2
2 0 0 0 0 0 0 0 1 0 0 0 1 0 0 2 0 0 1 2
2 0 0 2 2 1 0 0 2 2 2 3 2 2 2 2 1 0 0 2
2 0 0 2 2 0 0 0 2 3 2 2 2 3 2 2 0 0 1 2
2 0 0 2 2 0 0 0 3 2 3 2 2 2 2 0 0 0 0 2
2 0 0 2 1 0 0 1 2 2 2 3 2 3 2 0 0 0 0 2
2 1 0 2 2 0 0 0 2 3 2 2 3 2 2 0 1 0 0 2
2 0 0 3 2 0 0 0 2 2 2 1 2 0 0 0 0 0 0 2
2 0 0 2 2 0 0 0 2 2 3 2 2 0 0 0 0 0 2 2
2 0 0 2 2 0 0 0 2 3 2 0 0 0 0 0 0 0 2 2
2 0 0 3 2 0 0 0 3 1 2 1 0 0 0 0 3 2 2 2
2 0 0 2 2 0 0 0 0 0 1 1 0 0 0 0 2 2 3 2
2 0 0 2 3 0 0 1 0 0 0 0 0 0 2 2 3 2 2 2
2 0 0 2 2 0 0 1 0 0 0 0 0 0 3 2 2 3 2 2
2 0 0 2 1 2 3 2 2 2 2 3 2 2 2 3 2 2 2 2
2 0 0 2 3 1 2 3 2 3 2 2 1 3 2 3 2 2 3 2
2 0 0 1 0 0 0 0 0 1 1 0 0 0 0 0 0 0 2 2
2 0 0 0 0 1 0 0 0 0 0 0 1 0 0 0 0 0 2 2
2 2 3 2 3 2 2 2 3 2 3 2 2 2 3 2 0 0 2 2
2 2 3 2 2 2 3 2 2 3 2 2 2 3 2 2 0 0 2 2
2 0 0 0 0 0 0 0 0 0 0 0 0 0 0 0 0 0 2 2
2 0 0 0 0 0 0 0 0 0 0 0 0 0 0 0 0 0 2 2
2 1 1 1 1 1 1 1 1 4 4 4 1 1 1 1 1 1 1 2
3 9 0 1
3 10 0 1
3 11 0 1
2 5 5 2
1 5 6 1
1 5 7 1
1 17 12 1
1 18 12 1
2 5 15 2
2 1 24 2
2 8 23 2
2 9 23 2
2 18 30 2
1 17 30 1
1 16 30 1
2 10 42 2
2 2 35 2
2 16 48 2
2 17 48 2