40 20
38 9
13
1 0
2 2 2 3 2 2 2 2 2 0 0 0 2 2 2 2 2 2 2 3
2 0 0 0 0 0 0 0 0 0 0 0 0 0 1 0 0 0 0 2
2 0 0 0 0 0 0 0 0 0 1 0 0 0 0 0 0 0 0 2
2 2 0 0 0 2 2 2 3 2 2 2 2 2 2 2 2 2 2 2
2 2 0 0 1 3 2 2 2 3 2 1 2 1 2 2 2 3 2 2
3 2 0 0 1 0 0 0 0 0 0 2 2 2 2 2 3 1 2 2
2 2 0 1 0 0 1 0 0 0 0 2 2 3 2 2 2 2 2 2
2 2 0 0 0 0 0 0 0 0 0 2 1 3 1 2 2 2 1 2
3 2 3 2 2 3 2 2 0 0 0 2 2 2 2 2 3 2 2 3
2 2 2 2 3 2 2 2 0 0 0 2 2 3 2 2 2 2 2 2
2 1 3 2 3 2 0 0 0 0 0 0 0 2 2 3 2 3 2 2
2 2 3 2 2 2 1 0 0 0 0 0 0 2 2 2 2 2 2 2
2 1 2 2 3 2 0 0 1 0 0 0 0 2 2 3 2 3 2 2
2 2 2 2 0 0 0 0 1 1 1 0 0 0 0 2 2 2 2 2
2 2 3 2 0 0 0 0 1 2 1 0 0 0 0 3 2 3 2 2
2 2 0 0 0 0 1 1 1 2 1 1 1 0 0 0 0 2 2 2
2 2 0 0 0 0 1 2 3 2 2 2 1 0 0 0 0 2 2 2
2 3 0 0 1 1 1 2 2 3 2 2 1 1 1 0 1 2 3 2
2 2 1 0 1 2 2 3 2 2 3 2 2 2 1 0 0 2 2 2
3 2 0 0 1 2 2 3 2 3 2 2 3 2 1 0 0 3 2 2
2 2 0 0 1 1 1 1 1 1 1 1 1 1 1 0 0 2 2 2
2 2 0 0 0 0 0 0 0 0 0 1 0 0 0 0 0 2 2 2
3 2 0 1 0 0 0 0 0 0 0 0 0 0 0 0 0 2 3 2
1 2 0 0 0 3 2 2 3 2 2 2 2 2 3 2 3 2 2 2
1 1 0 0 0 2 2 2 3 2 2 2 3 2 2 2 2 3 2 2
2 2 0 0 0 1 0 0 0 0 0 0 0 0 0 0 0 0 1 2
3 2 0 0 0 1 0 0 0 1 0 0 0 1 0 0 0 0 0 2
2 2 0 0 0 0 0 0 0 1 0 0 0 0 0 0 1 0 0 2
2 2 3 2 2 2 2 2 2 3 2 2 3 2 2 2 1 0 0 2
2 3 2 2 2 3 2 2 2 3 2 2 2 2 3 2 0 0 0 2
2 3 2 0 0 0 0 0 0 0 1 2 2 2 2 2 0 0 0 2
2 3 2 0 1 0 0 0 1 0 0 2 2 2 2 2 0 1 0 2
2 2 2 0 0 0 2 2 0 0 0 0 0 0 0 0 0 0 0 2
2 3 2 0 0 0 1 1 0 0 0 0 1 0 0 0 0 0 0 2
2 3 2 0 1 0 3 3 2 2 3 2 2 3 2 2 2 3 2 2
2 2 2 0 0 0 2 2 3 2 2 3 2 2 2 3 2 2 2 2
2 0 0 0 0 0 0 0 0 0 0 0 0 0 0 0 0 0 0 2
2 0 0 0 0 0 0 0 0 0 0 0 0 0 0 0 0 0 0 2
2 0 0 0 0 0 0 0 0 0 0 0 0 0 0 0 0 0 0 2
2 1 1 1 1 1 1 1 1 4 4 4 1 1 1 1 1 1 1 2
1 5 27 1
1 3 17 1
1 17 26 1
2 10 12 2
2 11 12 2
2 12 12 2
2 13 12 2
1 8 8 1
1 9 8 1
1 10 8 1
3 9 0 100
3 10 0 100
3 11 0 100